#####
#   #
#   #
#   #
# @ #
#####
